{
  "level1": {
    "name": "Nivel 1 - Introducción",
    "enemyCount": 20,
    "enemyTypes": ["BASIC", "BASIC", "BASIC", "FAST"],
    "tiles": [
      [0,0,0,0,0,0,0,0,0,0,0,0,0,0,0,0,0,0,0,0,0,0,0,0,0,0],
      [0,0,0,0,0,0,0,0,0,0,0,0,0,0,0,0,0,0,0,0,0,0,0,0,0,0],
      [0,0,1,1,0,0,1,1,0,0,1,1,0,0,1,1,0,0,1,1,0,0,1,1,0,0],
      [0,0,1,1,0,0,1,1,0,0,1,1,0,0,1,1,0,0,1,1,0,0,1,1,0,0],
      [0,0,0,0,0,0,0,0,0,0,0,0,0,0,0,0,0,0,0,0,0,0,0,0,0,0],
      [0,0,1,1,0,0,1,0,0,1,1,1,1,1,1,1,1,0,0,1,0,0,1,1,0,0],
      [0,0,0,0,0,0,1,0,0,0,0,0,0,0,0,0,0,0,0,1,0,0,0,0,0,0],
      [0,1,1,1,1,1,1,1,1,0,0,1,1,1,1,0,0,1,1,1,1,1,1,1,1,0],
      [0,0,0,0,0,0,0,0,0,0,0,1,0,0,0,1,0,0,0,0,0,0,0,0,0,0],
      [0,1,1,1,1,1,1,1,1,0,0,1,0,0,0,1,0,0,1,1,1,1,1,1,1,0],
      [0,0,0,0,0,0,0,0,0,0,0,0,0,0,0,0,0,0,0,0,0,0,0,0,0,0],
      [0,0,1,1,0,0,1,1,1,1,1,0,0,0,0,1,1,1,1,1,0,0,1,1,0,0],
      [0,0,0,1,0,0,0,0,0,0,1,0,0,0,0,1,0,0,0,0,0,0,1,0,0,0],
      [0,1,0,1,0,0,1,0,0,0,1,0,0,0,0,1,0,0,0,1,0,0,1,0,1,0],
      [0,0,0,0,0,0,1,0,0,0,0,0,0,0,0,0,0,0,0,1,0,0,0,0,0,0],
      [0,1,0,1,0,0,1,0,0,0,1,1,1,1,1,1,0,0,0,1,0,0,1,0,1,0],
      [0,0,0,1,0,0,0,0,0,0,1,0,0,0,0,1,0,0,0,0,0,0,1,0,0,0],
      [0,0,1,1,0,0,1,1,1,1,1,0,0,0,0,1,1,1,1,1,0,0,1,1,0,0],
      [0,0,0,0,0,0,0,0,0,0,0,0,0,0,0,0,0,0,0,0,0,0,0,0,0,0],
      [0,1,1,1,1,1,1,1,1,0,0,1,0,0,0,1,0,0,1,1,1,1,1,1,1,0],
      [0,0,0,0,0,0,0,0,0,0,0,1,0,0,0,1,0,0,0,0,0,0,0,0,0,0],
      [0,1,1,1,1,1,1,1,1,0,0,1,1,1,1,0,0,1,1,1,1,1,1,1,1,0],
      [0,0,0,0,0,0,0,0,0,0,0,0,0,0,0,0,0,0,0,0,0,0,0,0,0,0],
      [0,0,0,0,0,0,0,0,0,0,0,0,0,0,0,0,0,0,0,0,0,0,0,0,0,0],
      [0,0,0,0,0,0,0,0,0,0,0,0,1,6,1,0,0,0,0,0,0,0,0,0,0,0],
      [0,0,0,0,0,0,0,0,0,0,0,0,0,0,0,0,0,0,0,0,0,0,0,0,0,0]
    ]
  },
  "level2": {
    "name": "Nivel 2 - Fortaleza",
    "enemyCount": 20,
    "enemyTypes": ["BASIC", "FAST", "FAST", "POWER"],
    "tiles": [
      [0,0,0,0,0,0,0,0,0,0,0,0,0,0,0,0,0,0,0,0,0,0,0,0,0,0],
      [0,0,0,0,0,0,0,0,0,0,0,0,0,0,0,0,0,0,0,0,0,0,0,0,0,0],
      [0,0,2,2,2,2,0,0,1,1,0,0,0,0,0,0,1,1,0,0,2,2,2,2,0,0],
      [0,0,2,0,0,2,0,0,1,1,0,0,0,0,0,0,1,1,0,0,2,0,0,2,0,0],
      [0,0,2,0,0,2,0,0,0,0,0,0,0,0,0,0,0,0,0,0,2,0,0,2,0,0],
      [0,0,2,2,2,2,0,0,1,1,1,1,1,1,1,1,1,1,0,0,2,2,2,2,0,0],
      [0,0,0,0,0,0,0,0,0,0,0,0,0,0,0,0,0,0,0,0,0,0,0,0,0,0],
      [0,0,0,1,1,0,0,2,2,2,2,2,2,2,2,2,2,2,2,0,0,1,1,0,0,0],
      [0,0,0,1,1,0,0,2,0,0,0,0,0,0,0,0,0,0,2,0,0,1,1,0,0,0],
      [0,0,0,0,0,0,0,2,0,3,3,3,3,3,3,3,3,0,2,0,0,0,0,0,0,0],
      [0,0,0,0,0,0,0,2,0,3,0,0,0,0,0,0,3,0,2,0,0,0,0,0,0,0],
      [0,0,0,0,0,0,0,2,0,3,0,0,0,0,0,0,3,0,2,0,0,0,0,0,0,0],
      [0,0,0,0,0,0,0,2,0,3,0,0,0,0,0,0,3,0,2,0,0,0,0,0,0,0],
      [0,0,0,0,0,0,0,2,0,3,0,0,0,0,0,0,3,0,2,0,0,0,0,0,0,0],
      [0,0,0,0,0,0,0,2,0,3,3,3,3,3,3,3,3,0,2,0,0,0,0,0,0,0],
      [0,0,0,1,1,0,0,2,0,0,0,0,0,0,0,0,0,0,2,0,0,1,1,0,0,0],
      [0,0,0,1,1,0,0,2,2,2,2,2,2,2,2,2,2,2,2,0,0,1,1,0,0,0],
      [0,0,0,0,0,0,0,0,0,0,0,0,0,0,0,0,0,0,0,0,0,0,0,0,0,0],
      [0,0,2,2,2,2,0,0,1,1,1,1,1,1,1,1,1,1,0,0,2,2,2,2,0,0],
      [0,0,2,0,0,2,0,0,0,0,0,0,0,0,0,0,0,0,0,0,2,0,0,2,0,0],
      [0,0,2,0,0,2,0,0,1,1,0,0,0,0,0,0,1,1,0,0,2,0,0,2,0,0],
      [0,0,2,2,2,2,0,0,1,1,0,0,0,0,0,0,1,1,0,0,2,2,2,2,0,0],
      [0,0,0,0,0,0,0,0,0,0,0,0,0,0,0,0,0,0,0,0,0,0,0,0,0,0],
      [0,0,0,0,0,0,0,0,0,0,0,0,0,0,0,0,0,0,0,0,0,0,0,0,0,0],
      [0,0,0,0,0,0,0,0,0,0,0,0,1,6,1,0,0,0,0,0,0,0,0,0,0,0],
      [0,0,0,0,0,0,0,0,0,0,0,0,0,0,0,0,0,0,0,0,0,0,0,0,0,0]
    ]
  },
  "level3": {
    "name": "Nivel 3 - Tierra Helada",
    "enemyCount": 20,
    "enemyTypes": ["BASIC", "FAST", "POWER", "BONUS"],
    "tiles": [
      [0,0,0,0,0,0,0,0,0,0,0,0,0,0,0,0,0,0,0,0,0,0,0,0,0,0],
      [0,0,0,0,0,0,0,0,0,0,0,0,0,0,0,0,0,0,0,0,0,0,0,0,0,0],
      [0,0,1,1,0,0,5,5,5,5,0,0,0,0,0,0,5,5,5,5,0,0,1,1,0,0],
      [0,0,1,1,0,0,5,5,5,5,0,0,0,0,0,0,5,5,5,5,0,0,1,1,0,0],
      [0,0,0,0,0,0,5,5,5,5,0,0,0,0,0,0,5,5,5,5,0,0,0,0,0,0],
      [0,0,1,1,0,0,5,5,5,5,0,0,0,0,0,0,5,5,5,5,0,0,1,1,0,0],
      [0,0,0,0,0,0,0,0,0,0,0,0,0,0,0,0,0,0,0,0,0,0,0,0,0,0],
      [0,0,2,2,2,2,2,2,0,0,1,1,1,1,1,1,0,0,2,2,2,2,2,2,0,0],
      [0,0,0,0,0,0,0,0,0,0,1,1,1,1,1,1,0,0,0,0,0,0,0,0,0,0],
      [0,0,0,0,0,0,0,0,0,0,1,1,1,1,1,1,0,0,0,0,0,0,0,0,0,0],
      [0,0,0,0,0,0,0,0,0,0,1,1,1,1,1,1,0,0,0,0,0,0,0,0,0,0],
      [0,0,0,0,0,0,0,0,0,0,1,1,1,1,1,1,0,0,0,0,0,0,0,0,0,0],
      [0,0,0,0,0,0,0,0,0,0,1,1,1,1,1,1,0,0,0,0,0,0,0,0,0,0],
      [0,0,2,2,2,2,2,2,0,0,1,1,1,1,1,1,0,0,2,2,2,2,2,2,0,0],
      [0,0,0,0,0,0,0,0,0,0,0,0,0,0,0,0,0,0,0,0,0,0,0,0,0,0],
      [0,0,1,1,0,0,5,5,5,5,0,0,0,0,0,0,5,5,5,5,0,0,1,1,0,0],
      [0,0,0,0,0,0,5,5,5,5,0,0,0,0,0,0,5,5,5,5,0,0,0,0,0,0],
      [0,0,1,1,0,0,5,5,5,5,0,0,0,0,0,0,5,5,5,5,0,0,1,1,0,0],
      [0,0,0,0,0,0,5,5,5,5,0,0,0,0,0,0,5,5,5,5,0,0,0,0,0,0],
      [0,0,1,1,0,0,5,5,5,5,0,0,0,0,0,0,5,5,5,5,0,0,1,1,0,0],
      [0,0,0,0,0,0,0,0,0,0,0,0,0,0,0,0,0,0,0,0,0,0,0,0,0,0],
      [0,0,0,0,0,0,0,0,0,0,0,0,0,0,0,0,0,0,0,0,0,0,0,0,0,0],
      [0,0,0,0,0,0,0,0,0,0,0,0,0,0,0,0,0,0,0,0,0,0,0,0,0,0],
      [0,0,0,0,0,0,0,0,0,0,0,0,0,0,0,0,0,0,0,0,0,0,0,0,0,0],
      [0,0,0,0,0,0,0,0,0,0,0,0,1,6,1,0,0,0,0,0,0,0,0,0,0,0],
      [0,0,0,0,0,0,0,0,0,0,0,0,0,0,0,0,0,0,0,0,0,0,0,0,0,0]
    ]
  }
}
